{
  "bpm":"120",
  "bar_length":"4",
  "beat_division":"2",
  "bar_delay":"8",
  "bar_preload":"4",
  "music_source":"line_theme.mp3",
  "columns":
    [
      "OOOOOOOOOX",
      "XOOOOOOOOO",
      "OOOOOOOOOX",
      "XOOOOOOOOO",
      "OOOOOOOOOX",
      "XOOOOOOOOO",
      "OOOOOOOOOX",
      "XOOOOOOOOO",
      "OOOOOOOOOX",
      "XOOOOOOOOO",
      "OOOOOOOOOX",
      "XOOOOOOOOO",
      "OOOOOOOOOX",
      "XOOOOOOOOO",
      "OOOOOOOOOX",
      "XOOOOOOOOO",
      "OOOOOOOOOX",
      "OXOOOOOOOO",
      "OOOOOOOOOX",
      "OXOOOOOOOO",
      "OOOOOOOOOX",
      "OXOOOOOOOO",
      "OOOOOOOOOX",
      "OXOOOOOOOO",
      "OOOOOOOOOX",
      "OXOOOOOOOO",
      "OOOOOOOOOX",
      "OXOOOOOOOO",
      "OOOOOOOOOX",
      "OXOOOOOOOO",
      "OOOOOOOOOX",
      "OXOOOOOOOO",
      "OOOOOOOOOX",
      "OOOXOOOOOO",
      "OOOOOOOOOX",
      "OOOXOOOOOO",
      "OOOOOOOOOX",
      "OOOXOOOOOO",
      "OOOOOOOOOX",
      "OOOXOOOOOO",
      "OOOOOOOOOX",
      "OOOXOOOOOO",
      "OOOOOOOOOX",
      "OOOXOOOOOO",
      "OOOOOOOOOX",
      "OOOXOOOOOO",
      "OOOOOOOOOX",
      "OOOXOOOOOO",
      "OOOOOOOOOX",
      "OOXOOOOOOO",
      "OOOOOOOOOX",
      "OOXOOOOOOO",
      "OOOOOOOOOX",
      "OOXOOOOOOO",
      "OOOOOOOOOX",
      "OOXOOOOOOO",
      "OOOOOOOOOX",
      "OOXOOOOOOO",
      "OOOOOOOOOX",
      "OOXOOOOOOO",
      "OOOOOOOOOX",
      "OOXOOOOOOO",
      "OOOOOOOOOX",
      "OOXOOOOOOO",
      "OOOOOOOOOX",
      "XOOOOOOOOO",
      "OOOOOOOXOO",
      "XOOOOOOOOO",
      "OOOOOOOOOX",
      "XOOOOOOOOO",
      "OOOOOOOXOO",
      "XOOOOOOOOO",
      "OOOOOOOOOX",
      "XOOOOOOOOO",
      "OOOOOOOXOO",
      "XOOOOOOOOO",
      "OOOOOOOOOX",
      "XOOOOOOOOO",
      "OOOOOOOXOO",
      "OXOOOOOOOO",
      "OOOOOOOOOX",
      "OXOOOOOOOO",
      "OOOOOOOXOO",
      "OXOOOOOOOO",
      "OOOOOOOOOX",
      "OXOOOOOOOO",
      "OOOOOOOXOO",
      "OXOOOOOOOO",
      "OOOOOOOOOX",
      "OXOOOOOOOO",
      "OOOOOOOXOO",
      "OXOOOOOOOO",
      "OOOOOOOOOX",
      "OXOOOOOOOO",
      "OOOOOOOXOO",
      "OXOOOOOOOO",
      "OOOOOOOOOX",
      "OOOXOOOOOO",
      "OOOOOOOXOO",
      "OOOXOOOOOO",
      "OOOOOOOOOX",
      "OOOXOOOOOO",
      "OOOOOOOXOO",
      "OOOXOOOOOO",
      "OOOOOOOOOX",
      "OOOXOOOOOO",
      "OOOOOOOXOO",
      "OOOXOOOOOO",
      "OOOOOOOOOX",
      "OOOXOOOOOO",
      "OOOOOOOXOO",
      "OOOXOOOOOO",
      "OOOOOOOOOX",
      "OOXOOOOOOO",
      "OOOOOOOXOO",
      "OOXOOOOOOO",
      "OOOOOOOOOX",
      "OOXOOOOOOO",
      "OOOOOOOXOO",
      "OOXOOOOOOO",
      "OOOOOOOOOX",
      "OOXOOOOOOO",
      "OOOOOOOXOO",
      "OOXOOOOOOO",
      "OOOOOOOOOX",
      "OOXOOOOOOO",
      "OOOOOOOXOO",
      "OOXOOOOOOO",
      "OOOOOXOOOO",
      "XOOOOOOOOO",
      "OOOOOXOOOO",
      "XOOOOOOOOO",
      "OOOOOXOOOO",
      "XOOOOOOOOO",
      "OOOOOXOOOO",
      "XOOOOOOOOO",
      "OOOOOXOOOO",
      "XOOOOOOOOO",
      "OOOOOXOOOO",
      "XOOOOOOOOO",
      "OOOOOXOOOO",
      "XOOOOOOOOO",
      "OOOOOXOOOO",
      "XOOOOOOOOO",
      "OOOOOOXOOO",
      "OXOOOOOOOO",
      "OOOOOOXOOO",
      "OXOOOOOOOO",
      "OOOOOOXOOO",
      "OXOOOOOOOO",
      "OOOOOOXOOO",
      "OXOOOOOOOO",
      "OOOOOOXOOO",
      "OXOOOOOOOO",
      "OOOOOOXOOO",
      "OXOOOOOOOO",
      "OOOOOOXOOO",
      "OXOOOOOOOO",
      "OOOOOOXOOO",
      "OXOOOOOOOO",
      "OOOOOOOOXO",
      "OOOXOOOOOO",
      "OOOOOOOOXO",
      "OOOXOOOOOO",
      "OOOOOOOOXO",
      "OOOXOOOOOO",
      "OOOOOOOOXO",
      "OOOXOOOOOO",
      "OOOOOOOOXO",
      "OOOXOOOOOO",
      "OOOOOOOOXO",
      "OOOXOOOOOO",
      "OOOOOOOOXO",
      "OOOXOOOOOO",
      "OOOOOOOOXO",
      "OOOXOOOOOO",
      "OOOOOOOXOO",
      "OOXOOOOOOO",
      "OOOOOOOXOO",
      "OOXOOOOOOO",
      "OOOOOOOXOO",
      "OOXOOOOOOO",
      "OOOOOOOXOO",
      "OOXOOOOOOO",
      "XOOOOOOOOX",
      "XOOOOOOOOX",
      "OXOOOOOOXO",
      "OXOOOOOOXO",
      "OOXOOOOOXO",
      "OOOXOOOOXO",
      "OOOOXOOOXO",
      "OOOOOXOOXO",
      "OOOOOXOOXO",
      "OOOOOXOOXO",
      "OOOOOOXOXO",
      "OOOOOXOOXO",
      "OOOOOXOXOO",
      "OOOOXOOXOO",
      "OOOOXOXOOO",
      "OOOOXOOXOO",
      "OOOOOXOXOO",
      "OOOOOXOOXO",
      "OOOOOOXOXO",
      "OOOOOXOOXO",
      "OOOOOXOXOO",
      "OOOOXOOXOO",
      "OOOOXOXOOO",
      "OOOOXOOXOO",
      "OOOOOXOXOO",
      "OOOOOXOOXO",
      "OOOOOOXOXO",
      "OOOOOXOOXO",
      "OOOOOXOXOO",
      "OOOOXOOXOO",
      "OOOOXOXOOO",
      "OOOOXOOXOO",
      "OOOOOXOXOO",
      "OOOOOXOOXO",
      "OOOOOOXOXO",
      "OOOOOXOOXO",
      "OOOOOXOXOO",
      "OOOOXOOXOO",
      "OOOOXOXOOO",
      "OOOXOOXOOO",
      "OOOXOXXXOO",
      "OOOXOOOOXO",
      "OOOOXOOOXO",
      "OOOOOXOOXO",
      "OOOOXOOXOO",
      "OOOOXOXOOO",
      "OOOOXOOXOO",
      "OOOOOXOXOO",
      "OOOOOXOOXO",
      "OOOOOOXOXO",
      "OOOOOXOOXO",
      "OOOOOXOXOO",
      "OOOOXOOXOO",
      "OOOOXOXOOO",
      "OOOOXOOXOO",
      "OOOOOXOXOO",
      "OOOOOXOOXO",
      "OOOOOOXOXO",
      "OOOOOXOOXO",
      "OOOOOXOXOO",
      "OOOOXOOXOO",
      "OOOOXOXOOO",
      "OOOOXOOXOO",
      "OOOOOXOXOO",
      "OOOOOXOOXO",
      "OOOOOOXOXO",
      "OOOOOXOOXO",
      "OOOOOXOXOO",
      "OOOOXOOXOO",
      "OOOOXOXOOO",
      "OOOXOOXOOO",
      "OOOXOXOOOO"
    ]
}