{
  "bpm":"120",
  "bar_length":"4",
  "beat_division":"2",
  "bar_delay":"8",
  "bar_preload":"4",
  "music_source":"line_theme.mp3",
  "columns":
    [
      "OOOOOOOOOX",
      "*OOOOOOOOO",
      "OOOOOOOOOX",
      "*OOOOOOOOO",
      "OOOOOOOOOX",
      "*OOOOOOOOO",
      "OOOOOOOOOX",
      "*OOOOOOOOO",
      "OOOOOOOOOX",
      "*OOOOOOOOO",
      "OOOOOOOOOX",
      "*OOOOOOOOO",
      "OOOOOOOOOX",
      "*OOOOOOOOO",
      "OOOOOOOOOX",
      "*OOOOOOOOO",
      "OOOOOOOOOX",
      "O*OOOOOOOO",
      "OOOOOOOOOX",
      "O*OOOOOOOO",
      "OOOOOOOOOX",
      "O*OOOOOOOO",
      "OOOOOOOOOX",
      "O*OOOOOOOO",
      "OOOOOOOOOX",
      "O*OOOOOOOO",
      "OOOOOOOOOX",
      "O*OOOOOOOO",
      "OOOOOOOOOX",
      "O*OOOOOOOO",
      "OOOOOOOOOX",
      "O*OOOOOOOO",
      "OOOOOOOOOX",
      "OOO*OOOOOO",
      "OOOOOOOOOX",
      "OOO*OOOOOO",
      "OOOOOOOOOX",
      "OOO*OOOOOO",
      "OOOOOOOOOX",
      "OOO*OOOOOO",
      "OOOOOOOOOX",
      "OOO*OOOOOO",
      "OOOOOOOOOX",
      "OOO*OOOOOO",
      "OOOOOOOOOX",
      "OOO*OOOOOO",
      "OOOOOOOOOX",
      "OOO*OOOOOO",
      "OOOOOOOOOX",
      "OO*OOOOOOO",
      "OOOOOOOOOX",
      "OO*OOOOOOO",
      "OOOOOOOOOX",
      "OO*OOOOOOO",
      "OOOOOOOOOX",
      "OO*OOOOOOO",
      "OOOOOOOOOX",
      "OO*OOOOOOO",
      "OOOOOOOOOX",
      "OO*OOOOOOO",
      "OOOOOOOOOX",
      "OO*OOOOOOO",
      "OOOOOOOOOX",
      "OO*OOOOOOO",
      "OOOOOOOOO*",
      "*OOOOOOOOO",
      "OOOOOOO*OO",
      "*OOOOOOOOO",
      "OOOOOOOOO*",
      "*OOOOOOOOO",
      "OOOOOOO*OO",
      "*OOOOOOOOO",
      "OOOOOOOOO*",
      "*OOOOOOOOO",
      "OOOOOOO*OO",
      "*OOOOOOOOO",
      "OOOOOOOOO*",
      "*OOOOOOOOO",
      "OOOOOOO*OO",
      "O*OOOOOOOO",
      "OOOOOOOOO*",
      "O*OOOOOOOO",
      "OOOOOOO*OO",
      "O*OOOOOOOO",
      "OOOOOOOOO*",
      "O*OOOOOOOO",
      "OOOOOOO*OO",
      "O*OOOOOOOO",
      "OOOOOOOOO*",
      "O*OOOOOOOO",
      "OOOOOOO*OO",
      "O*OOOOOOOO",
      "OOOOOOOOO*",
      "O*OOOOOOOO",
      "OOOOOOO*OO",
      "O*OOOOOOOO",
      "OOOOOOOOO*",
      "OOO*OOOOOO",
      "OOOOOOO*OO",
      "OOO*OOOOOO",
      "OOOOOOOOO*",
      "OOO*OOOOOO",
      "OOOOOOO*OO",
      "OOO*OOOOOO",
      "OOOOOOOOO*",
      "OOO*OOOOOO",
      "OOOOOOO*OO",
      "OOO*OOOOOO",
      "OOOOOOOOO*",
      "OOO*OOOOOO",
      "OOOOOOO*OO",
      "OOO*OOOOOO",
      "OOOOOOOOO*",
      "OO*OOOOOOO",
      "OOOOOOO*OO",
      "OO*OOOOOOO",
      "OOOOOOOOO*",
      "OO*OOOOOOO",
      "OOOOOOO*OO",
      "OO*OOOOOOO",
      "OOOOOOOOO*",
      "OO*OOOOOOO",
      "OOOOOOO*OO",
      "OO*OOOOOOO",
      "OOOOOOOOO*",
      "OO*OOOOOOO",
      "OOOOOOO*OO",
      "OO*OOOOOOO",
      "OOOOO*OOOO",
      "*OOOOOOOOO",
      "OOOOO*OOOO",
      "*OOOOOOOOO",
      "OOOOO*OOOO",
      "*OOOOOOOOO",
      "OOOOO*OOOO",
      "*OOOOOOOOO",
      "OOOOO*OOOO",
      "*OOOOOOOOO",
      "OOOOO*OOOO",
      "*OOOOOOOOO",
      "OOOOO*OOOO",
      "*OOOOOOOOO",
      "OOOOO*OOOO",
      "*OOOOOOOOO",
      "OOOOOO*OOO",
      "O*OOOOOOOO",
      "OOOOOO*OOO",
      "O*OOOOOOOO",
      "OOOOOO*OOO",
      "O*OOOOOOOO",
      "OOOOOO*OOO",
      "O*OOOOOOOO",
      "OOOOOO*OOO",
      "O*OOOOOOOO",
      "OOOOOO*OOO",
      "O*OOOOOOOO",
      "OOOOOO*OOO",
      "O*OOOOOOOO",
      "OOOOOO*OOO",
      "O*OOOOOOOO",
      "OOOOOOOO*O",
      "OOO*OOOOOO",
      "OOOOOOOO*O",
      "OOO*OOOOOO",
      "OOOOOOOO*O",
      "OOO*OOOOOO",
      "OOOOOOOO*O",
      "OOO*OOOOOO",
      "OOOOOOOO*O",
      "OOO*OOOOOO",
      "OOOOOOOO*O",
      "OOO*OOOOOO",
      "OOOOOOOO*O",
      "OOO*OOOOOO",
      "OOOOOOOO*O",
      "OOO*OOOOOO",
      "OOOOOOO*OO",
      "OO*OOOOOOO",
      "OOOOOOO*OO",
      "OO*OOOOOOO",
      "OOOOOOO*OO",
      "OO*OOOOOOO",
      "OOOOOOO*OO",
      "OO*OOOOOOO",
      "*OOOOOOOO*",
      "*OOOOOOOO*",
      "O*OOOOOO*O",
      "O*OOOOOO*O",
      "OO*OOOOO*O",
      "OOO*OOOO*O",
      "OOOO*OOO*O",
      "OOOOO*OO*O",
      "OOOOO*OO*O",
      "OOOOO*OO*O",
      "OOOOOO*O*O",
      "OOOOO*OO*O",
      "OOOOO*O*OO",
      "OOOO*OO*OO",
      "OOOO*O*OOO",
      "OOOO*OO*OO",
      "OOOOO*O*OO",
      "OOOOO*OO*O",
      "OOOOOO*O*O",
      "OOOOO*OO*O",
      "OOOOO*O*OO",
      "OOOO*OO*OO",
      "OOOO*O*OOO",
      "OOOO*OO*OO",
      "OOOOO*O*OO",
      "OOOOO*OO*O",
      "OOOOOO*O*O",
      "OOOOO*OO*O",
      "OOOOO*O*OO",
      "OOOO*OO*OO",
      "OOOO*O*OOO",
      "OOOO*OO*OO",
      "OOOOO*O*OO",
      "OOOOO*OO*O",
      "OOOOOO*O*O",
      "OOOOO*OO*O",
      "OOOOO*O*OO",
      "OOOO*OO*OO",
      "OOOO*O*OOO",
      "OOO*OO*OOO",
      "OOO*O***OO",
      "OOO*OOOO*O",
      "OOOO*OOO*O",
      "OOOOO*OO*O",
      "OOOO*OO*OO",
      "OOOO*O*OOO",
      "OOOO*OO*OO",
      "OOOOO*O*OO",
      "OOOOO*OO*O",
      "OOOOOO*O*O",
      "OOOOO*OO*O",
      "OOOOO*O*OO",
      "OOOO*OO*OO",
      "OOOO*O*OOO",
      "OOOO*OO*OO",
      "OOOOO*O*OO",
      "OOOOO*OO*O",
      "OOOOOO*O*O",
      "OOOOO*OO*O",
      "OOOOO*O*OO",
      "OOOO*OO*OO",
      "OOOO*O*OOO",
      "OOOO*OO*OO",
      "OOOOO*O*OO",
      "OOOOO*OO*O",
      "OOOOOO*O*O",
      "OOOOO*OO*O",
      "OOOOO*O*OO",
      "OOOO*OO*OO",
      "OOOO*O*OOO",
      "OOO*OO*OOO",
      "OOO*O*OOOO"
    ]
}